width:20
height:20
00100000000000000000
00133333333333333300
00111111111111111100
00000000000000000100
00000000000000000100
00333333333333333100
00111111111111111100
00100000000000000000
00133333333333333300
00111111111111111100
00000000000000000100
00000000000000000100
00000000000000000100
00333333333333333100
00111111111111111100
00100000000000000000
00133333333333333300
00111111111111111100
00000000000000000100
00000000000000000000
