10000000000000000000
11111001111000111100
00001001001000100100
00001001001000100100
00001001001000100100
00001001001000100100
00001001001000100110
00001001001000100010
00001001001000100010
22221221221222122212
22221221221222122212
00001001001000100010
00001111001000100010
00000000001000100010
01111111111000100010
01000000000000100010
01000000000000100010
01000000000000100010
01111111111111100110
00000000000000000000
