10000000000000000000
11111111111111111111
00000000000000000001
11111111111111111101
10000000000000000101
10111111111111110101
10100000000000010101
10101111111111010101
10101000000001010101
10101011111101010101
10101010000101010101
10101010011101010101
10101010000001010101
10101011111111010101
10101000000000010101
10101111111111110101
10100000000000000101
10111111111111111101
10000000000000000001
11111111111111111111
